NO ./textures/north.xpm
SO ./textures/south.xpm
WE ./textures/west.xpm
EA ./textures/east.xpm

F 0,128,255
C 64,64,64

11111
10001
10S01
10001
11111
