NO ./textures/north.xpm
SO ./textures/south.xpm
WE ./textures/west.xpm
EA ./textures/east.xpm
EA ./textures/east.xpm


F 220,100,0
C 225,30,0

111
1N1
1111111111111
