NO ./textures/north.xpm
SO ./textures/south.xpm
WE ./textures/west.xpm
EA ./textures/east.xpm

F 255,0,0
C 0,0,255

111111
100001
100E01
100001
111111
