NO ./textures/north.xpm
SO ./textures/south.xpm
WE ./textures/west.xpm
EA ./textures/east.xpm

F 0,255,0
C 128,0,128

11111
1W001
10001
11111
