NO ./textures/north.xpm
SO ./textures/south.xpm
WE ./textures/west.xpm
EA ./textures/east.xpm

F 100,200,150
C 30,30,30

   1111
   1001
11111001
1N000001
11111001
   1001
   1111
