NO ./textures/north.xpm
SO ./textures/south.xpm
WE ./textures/west.xpm
EA ./textures/east.xpm

F 100,150,200
C 50,50,50

1111111
1000001
1000001
111D111
1000001
100N001
1111111
