NO ./path_to_the_north_texture
SO ./path_to_the_south_texture
WE ./path_to_the_west_texture
EA ./path_to_the_east_texture


F 220,100,0
C 225,30,0



        111111111
      1110000000111
     110000000000011
    11000011111000011
    11000N100001000011
    11000011111000011
     110000000000011
      1110000000111
        111111111
