NO ./textures/north.xpm
SO ./textures/south.xpm
WE ./textures/west.xpm
EA ./textures/east.xpm


F 220,100,0
C 225,30,0



    1111111111          111111111
    1N00000001          100000001
    1001111001          101111101
    1000000001          100000001
    1111111111          111111111
